7 11
01111111111
10000010001
11101110101
10001000101
10111011111
10000000001
11111111110


