29 27
011111111111111111111111111
100010000000001000000000001
101010111110101111101111101
101000001000100000101000001
101111111011111110111011101
100010000010000010001010101
111110111110111111101010101
100000100000100000100010001
101111101111101011111110111
100000101000001000100010001
101110101011111110101011101
101000101010001000101000001
101011101010101011101111111
101000100010100010001010001
111110111110111010111010101
100010000010001010001000101
101011111011101011101111101
101000000010001000100000101
101111111110111011111110101
101000000000100010000010001
101110111110111110101111101
100010100000100010101000101
111010111011101010101010101
100010001000101010100010001
101110101111101010111111111
101010101000001010100000001
101010101011111010111011101
100010100000001000000010001
111111111111111111111111110


