41 41
01111111111111111111111111111111111111111
10000000100000000000000010000000000000001
10111010111011111011111011111110111111101
10101010001010000010001000000010000000101
10101011101110111111101111111011111110101
10101000100000100000001000000000001000101
10101110111111101111111011111111101011101
10100010001000000000000010000010000010001
10101011101111111111101110111010111111101
10001000101000000000100010100010100000101
11111110101011111010111110101011101110101
10001000100010001010100000101010001000101
10101111111110101110101111101110111011111
10100000000000100010000010001000101000001
10111011111111111011111010111011101111101
10100010000010000000001010001000100000101
10111010111011111111101111101110101110101
10001010101000100000100000100000001000101
10101110101110101110111110111111111111101
10100010100010000010100010001000000010001
10111010111011111110101111101011111010101
10100010000010001000100010001010000000101
11101011111010101011101010111011111111111
10001000100010101000101000001010000000001
10111111101110101110111111101010111111101
10000000001000100010000010101000100010001
10111111111111101011111010101110101010101
10100000000000101010000010100010101000101
10111011111110111010111110111011101111101
10000010100000100010100010001010001000101
11111110101111101110101010101010111010101
10001000100000001000101010101000100010101
10101010111111101011101010111111101011101
10100010100010001000001010000000101010001
10111110101010111111111011101111101010111
10000010001010000010000010100000001000101
10111010111111101110111110111111101111101
10001010100000101000100010000000100010001
11101011101110101011101011111110111010101
10001000000010001000001000000000100000101
11111111111111111111111111111111111111110


